#######################################
#....................................T#
#.....................................#
#.....................................#
#.....................................#
#.........#############################
#.....................................#
#.....................................#
#.....................................#
#.....................................#
#.....................................#
#.....................................#
#.....................................#
#.....................................#
#.....................................#
#.....................................#
#.....................................#
#.....................................#
#.....................................#
#.....................................#
#.....................................#
#.....................................#
#.....................................#
#.....................................#
#.....................................#
#.....................................#
#......................S..............#
#.....................................#
#.....................................#
#######################################